nana
natin
==nawpa
nina =
fuego
nipaa -= hablarle = = speak to
niraq = semejante = = similar
higado = = liver
pampa =
panka- =
oqe = gris = = grey
oqetikín = ano = = anus
oqla- = dormir entre dos = = sleep 2 together
oqra-= perder = = lose
oqraka(yku)-= perderse = = get lost
oqti- = escavar = = dig
niti- = machucar = = crush
nuki - = levantar los ojos y la cabeza = = raise head and eyes
ñampusi- = ablandarse = = get sof
ñaña = bebe = = baby
ñuktu-= marchitarse, secarse = = wilt, dry up
ñupu = fruta silvestre = = a wild fruit
ojjo = mojado = = wet (noun: see OQU-)
amarrar las piernas juntas
=
=13
hobble
pacha = estómago = = stomach
paka-= esconder == hide
pakapaka = lechuza = = owl
paki- =  romper = = break
pakla = descubierto = = uncover
pala- = recojer = = gather
palchacha -= salpicar = = sprinkle
palta = chata, plana = = flat
brother (of woman)
