pisanaku- = barrernos = = sweep out
pishi = falta = = fault
pishqu = pájaro, órgano sexual del varón =
PINCHU)
pishta- =
pispis =
pisqa =
pisqaku-= lavar la ropa del finado en 5 días = =
person$in 5 days
pitu- = envolver = = wrap up
poqoshqa = maduro = = mature (adjective)
puchqo= salado = = salty
puchquq acido = = acid, bitter
puka-= soplar = = blow
desollar (cortar y abrir el frente) = = skin
juego con piedrecitas = = game (using pebbles)
cinco = = fivepukaya-= sonrojarse, ponerse colorado = = blush
pukla-= jugar = = play
puku = plato de madera = = wooden plate
pukutamu- = nublarse = = cloud over
pukutay = neblina o nube = = fog or cloud
pukyu = manantial = = sring
pullan = la mitad = = half
pultutu- hervir fuertamente, salpicar, gambullir =
puma = puma = = puma
pumeekamushqa = animal comido por el puma = =pumpu = yierba alta y gruesa = =
punku = puerta = = door
punta = pico = = beak
punu- = dormir = = sleep
pununa = cama = = bed
puqu- = madurar = = mature (verb)
puraya- = sacar a dos manos = =
puraya- = sacar a dos manos ==
puri-= andar = = go
puru = porongo de mate para chicha = =
pusha-= guiar = = guide
pushlluku-= quemarse = = burn self
pushpu = clase defrijol = = type of butn
pushqan = espuma = = foam
puska-= hilar = = weave
puura- = limpiar grano al aire = = winnow15
= bird, male sex organ (see
wash clothes of dead
take out with both hands (see APTA-)
take out with both hands (see APTA-)
= boid strongly, spatter
animal eaten by puma
chicha bowl
thick tall weed