puusha =
puwa- =puywan
puywanqaaya-
qacha-
qachi =qaara = penca====cascara de trigo =
hervir = = boilcarazon songo = =
corazón de animal =llamar===arrastrar = = drag
paja de puna (para soga) = = straw from the puna (for ropes)=maguey
callqapsi- = exprimir = = squeeze out
qapuka- = bajar la hinchazón = = go down (swelling)qapra = ciego = = blind
qapshu- = romper lo que es blando adentro = = break something with a soft interior=qaqa = peña, roca grande
= = peak, big rock 
qaqapayku- = estar duro por el frío = = be hard with cold
qaqara- = estar juntos = = be together
qaqla = cara = = face
qaqla = mejilla = cheek
qaqu- = frotar, masajear = = rub, massage
qara- = dar de comer, regalar = = feed, give gifts
qara = piel, cuero = = skin, leather
qaracha- = arrastrar = drag
qaran = cáscara hull, shell 
qarapacha- = comer mucho = = eat a lot???wheat hulls=heart of animalwhere a potato has been removed
16qachqa = áspero = = rough
qajapa = hielo = = ice, frost
qalapaachu = desnudo = = nude
qalapacha = desnudor = = nudity
qalla- = empezar = = begin
qalpa = donde se ha sacado papa = = 
qalti- = rodar = = ???
qalu = lengua = = tongue
qamla = fade = = tasteless
qamsi- = exprimir- = squeeze out
qanyaanin = anteayer = = the day before yesterday
qanyan wata = el año pasado = = last year
qanyannam = ayer = = yesterday
qapari- = gritar = = = shout
qapchi- = cerrar candado = = lock
qapi- = ordeñar = = milk (verb)