qarpa- = regar = water (verb)
qarpu- = botar despacio, llenar un pozo o vasija = = fill a well or vessel
qarqa = loro = = parrot
qarqu- = echar a recipiente, llenar = = fill, pour into recepticle
qaruwa- = caer gotas de lluvia = = fall (raindrops)qarwa- = madurar (fruta), dar color =
qarwash = amarillo = = yellow
qasha- = abrir cerca de espinas = =
qashpa- quemar mazorca o pelo =qata- = frazada = = blanket
qata-= techar roof (verb)
qats(u)wa- = bailar = dance
qawa- = mirar, ahuetar, ver = = look, watch
qawi- = batir, remover = = beat, stir
qaya- = llamar = = call
qayapaaku- = insultar = = insult
qayapaanaku- = insultarse = = insult one another
qeeku- = encerrar ganado = = corral cows
qela = ocioso = = lazy
qelay= plata, dinero = = money, silver
qeli- = regalar a una persona = = give
qelipa- = sostener =
qellqa- = escribir = =
write
qema- = botar de cosa hervida, escurirse = = skim
qemsi- =cerrar los ojos = =
close the eyesqemsi- = encojer = = shrivel
qencha = huerto = = orchard
genrish= moscón = = large fly
qenti- = jorobarse = = become hunchback (?)
qера- = atrasarse = = get behind
qepa = atrás = = behind
qері- = envolver = = wrap up
qepsha = párpados = = eyelashes
qeqe = espiritu malo = = evil spirit
qeru = madera = = wood
qeshpiku-= pasar al otro lado del cerro = =
qeshwa = nido = = nest
qeshya- = enfermarse, estar enfermo = = be sick
qeshyanaq = ha sido enfermo = = has been sick
qesqa- = agacharse = = squatopen a thorn corralburn (ear of corn, hair)= ripen, get colored17go behind a mountain