qesu =
qetu =
qewa = pasto = = pasturaje
qewlla = = ave de puna = = bird of the punaqo- = dar = = give
qocha = laguna = = lagoon
qocharayka- = no correr agua = =
qochi- = quitar= = leave
qochqu- = moler bien = =qochqu = harina fina = =
qochqu = molido fino = =rancha, enfermedad de papa = = a potato disease
lana sucia (cuando se saca de la oveja) = = dirty wool (from sheep)qoli- = cubrir candela con cenizas = =
qolmi = cuando no tiene dulce ni sal = =
qoloq = solo = = alone
qolu- = irse acabando = = becomming extinct
qolu = tronco = = trunk of tree qompa- = tirar piedras = = throw stones
qonqa- = olvidar = = forget
qonqori- = arrodillarse = = kneel
qontata- = humear = = smokeqontay  = humo = = smoke
qontsu = heces = = dregs
qontsu = turbio = = dirty (liquid)
qonumsa = nueva chicha = new chicha
qoñu = tibio = = warm
qopiku- = prepararse su cama = fix ones bed
qora =  yerba = = weed
qoraa(ku)- = sacar yerba = = pull up weeds
qorishpa = corazón de mazorca = = heart of corn cobgrind well
fine flourground finestagnate (water)qoyu- = ponerse morado = get purple
rachak = sapo, rana = = frog
rachakpa millwan = asura del agua = = scum on waterqoya = las 6 y media de la tarde, las 8 de la noche 
 = = 6:30 p.m., 8 p.m.
qoyku- = dar algo importante =  = give something of importance18scum on watercover the coals with ashes
lacking sweetness or saltqorpa = huesped = = guest
qotu = amontonado = = piled
qotuku- = amontonar = = pile up
qowa = marido = = husband
qoya- = pasarse el día = = pass (day)
qoya-qoyalla = pasar el día = = pass the time of day 